E111111111111111111111111
1C000000000000000000000C1
1001100001100011111100001
1001100C011001100C0110001
1001100001100000000110001
10011111111P0011111100001
10000C0001100110000000001
1000000001100110000000001
1000000001100111111110001
100000000C00000000000C001
1111111111111111111111111
