1111111111111111111111111111
100000N00000000000N000000001
100000000C0000000000P0000001
100000C000000C00000000N00001
100E00000C0000000000N0000001
1111111111111111111111111111